1111111111111111111111111111111111111111111111111111111111111111111111111111111111111111111111111111111111111111111111
1111111111111111111111111111111111111111111111111111111111111111111111111111111111111111111111111111111111111111111111
1111111111111111111111111111111111111111111111111111111111111111111111111111111111111111111111111111111111111111111111
1111111111111111111111111111111111111111111111111111111111111111111111111111111111111111111111111111111111111111111111
1111111111111111111111111111111111111111111111111111111111111111111111111111111111111111111111111111111111111111111111
1111111111111111111111111111111111111111111111111111111111111111111111111111111111111111111111111111111111111111111111
1111111111111111000000000000000000000000100000000000000000000000000011111111111111111111111111111111111111111111111111
1111111111111111000000000000000000000000010000000000000000000000000011111111111111111111111111111111111111111111111111
1111111111111111000000000000000000000000010000000000000000000000000011111111111111111111111111111111111111111111111111
1111111111111111000000000000000000000000010000000000000000000000000011111111111111111111111111111111111111111111111111
1111111111111111000000000000000000000000000000000000100000000000000011111111111111111111111111111111111111111111111111
1111111111111111111111111111111111111111111000000000000000000000000100000000000000000111111111111111111111111111111111
1111111111111111111111111111111111111111111111000000000000000000000000100000000000000000111111111111111111111111111111
1111111111111111111111111111111111111111111111110000000000000000000000001000000000000000001111111111111111111111111111
1111111111111111111111111111111111111111111100000000000000000000000010000000000000000011111111111111111111111111111111
1111111111111111111111111111111111111111111111100000000000000000000000010000000000000000011111111111111111111111111111
1111111111111111111111111111111111111111111000000000000000000000000100000000000000000111111111111111111111111111111111
1111111111111111111111111111111111111111111000000000000000000000000100000000000000000111111111111111111111111111111111
1111111111111111111111111111111111111111111000000000000000000000000100000000000000000111111111111111111111111111111111
1111111111111111111111111111111111111111111000000000000000000000000100000000000000000111111111111111111111111111111111
1111111111111111111111111111111111111111111000000000000000000000000100000000000000000111111111111111111111111111111111
1111111111111111111111111111111111111111111000000000000000000000000100000000000000000111111111111111111111111111111111
1111111111111111111111111111111111111111111000000000000000000000000100000000000000000111111111111111111111111111111111
1111111111111111111100000000000000000000000000000000000000000000000100000000000000000111111111111111111111111111111111
1111111111111111111111111111111111111111111000000000000000000000000100000000000000000111111111111111111111111111111111
1111111111111111111111111111111111111111111000000000000000000000000100000000000000000111111111111111111111111111111111
1111111111111111000000000000000000000000000000000000000000000000000100000000000000000111111111111111111111111111111111
1111111111111111000000000000000000000000000000000000000000000000000100000000000000000111111111111111111111111111111111
1111111111111111000000000000000000000000000000000000000000000000000100000000000000000111111111111111111111111111111111
1111111111111111000000000000000000000000000000000000000000000000000100000000000000000111111111111111111111111111111111
1111111111111111000000000000000000000000000000000000000000000000000100000000000000000111111111111111111111111111111111
1111111111111111000000000000000000000000000000000000000000000000000100000000000000000111111111111111111111111111111111
1111111111111111000000000000000000000000000000000000000000000000000100000000000000000111111111111111111111111111111111
1111111111111111000000000000000000000000000000000000000000000000000100000000000000000111111111111111111111111111111111
1111111111111111000000000000000000000000000000000000000000000000000100000000000000000111111111111111111111111111111111
1111111111111111000000000000000000000000000000000000000000000000000100000000000000000111111111111111111111111111111111
1111111111111111000000000000000000000000000000000000000000000000000100000000000000000111111111111111111111111111111111
1111111111111111000000000000000000000000000000000001111111111111111111111111100011111111111111111111111111111111111111
1111111111111111000000000000000000000000000000000001111111111111111111111111100011111111111111111111111111111111111111
1111111111111111000000000000000000000000000000000001111111111111111111111111100011111111111111111111111111111111111111
1111111111111111000000000000000000000000000000000001111111111111111111111111100011111111111111111111111111111111111111
1111111111111111000000000000000000000000000000000001111111111111111111111111100011111111111111111111111111111111111111
1111111111111111000000000000000000000000000000000001111111111111111100000000000000000000000000000000000000010000011111
1111111111111111000000000000000000000000000000000001111111111111111100000000000000000000000000000000000000010000011111
1111111111111111000000000000000000000000000000000001111111111111111100000000000000000000000000000000000000010000011111
1111111111111111000000000000000000000000000000000001111111111111111100000000000000000000000000000000000000010000011111
1111111111111111000000000000000000000000000000000001111111111111111100000000000000000000000000000000000000010000011111
1111111111111111000000000000000000000000000000000000000000000000000000000000000000010000011111111111111111111111111111
1111111111111111000000000000000000000000000000000001111111111111111111111111111111111111111111111111111111111111111111
1111111111111111000000000000000000000000000000000001111111111111111111111111111111111111111111111111111111111111111111
1111111111111111000000000000000000000000000000000001111111111111111111111111111111111111111111111111111111111111111111
1111111111111111000000000000000000000000000000000001111111111111111111111111111111111111111111111111111111111111111111
1111111111111111000000000000000000000000000000000001111111111111111111111111111111111111111111111111111111111111111111
1111111111111111000000000000000000000000000000000001111111111111111111111111111111111111111111111111111111111111111111
1111111111111111000000000000000000000000000000000001111111111111111111111111111111111111111111111111111111111111111111
1111111111111111000000000000000000000000000000000001111111111111111111111111111111111111111111111111111111111111111111
1111111111111111000000000000000000000000000000000001111111111111111111111111111111111111111111111111111111111111111111
1111111111111111111111111111111111111111111111111111111111111111111111111111111111111111111111111111111111111111111111
1111111111111111111111111111111111111111111111111111111111111111111111111111111111111111111111111111111111111111111111
1111111111111111111111111111111111111111111111111111111111111111111111111111111111111111111111111111111111111111111111
1111111111111111111111111111111111111111111111111111111111111111111111111111111111111111111111111111111111111111111111
1111111111111111111111111111111111111111111111111111111111111111111111111111111111111111111111111111111111111111111111
1111111111111111111111111111111111111111111111111111111111111111111111111111111111111111111111111111111111111111111111
1111111111111111111111111111111111111111111111111111111111111111111111111111111111111111111111111111111111111111111111
1111111111111111111111111111111111111111111111111111111111111111111111111111111111111111111111111111111111111111111111
