0000000000000000000000000
0000000000000000000100000
0000111111000000000000000
0000001111111111100000000
0000000000111100000110000
0000000000000000000110000
0000000000010000000000000
0000010000000010000000100
0000010000000010000000100
0000000000000010000000100
0000010000000010000000100
0000010000000010000000100
0000000000000000100000000
0011111000000000000000000
0000000000000100000000001
0000000000000100000000001
0000000000000100000000001
0000000000000100000000001
0000000000000100000000001
