0000000000000
0000000000000
0000111111000
0000001111111
0000000000111
0000000000000
0000000000010
