00000000000000000000000000
00000000000000000000000000
00000000000000000000000000
00000000000000000000000000
00001111110000000111111000
00001111110000000111111000
00000011111110000001111111
00000011111110000001111111
00000000001110000000000111
00000000001110000000000111
00000000000000000000000000
00000000000000000000000000
00000000000100000000000010
00000000000100000000000010
