111111111
100010001
101010101
100010101
111111111
