111111111
100010001
101010101
100000101
111111111
