{"map": [
[    0,    1,    1,    1,    1,    1,    1,    1,    1,    1,    1,    1,    1,    1,    1,    1,    1,    1,    1],
[    0,    1,    0,    0,    0,    0,    0,    0,    0,    0,    0,    0,    0,    0,    0,    0,    0,    1,    1],
[    0,    1,    3,    4,    8,    8,    3,    4,    3,    4,    3,    4,    3,    4,    0,    0,    0,    0,    0],
[    1,    1,    4,    3,    8,   13,    4,    3,    4,    3,    4,    3,    4,    3,    0,    0,    0,    0,    0],
[    0,    1,    3,    5,    9,   14,    3,    4,    8,   21,   25,   32,    3,    4,   35,   38,   38,   38,   38],
[    0,    1,    4,    6,   10,   15,    4,    3,    8,   21,   25,   32,    4,    3,   36,   39,   39,   39,   39],
[    0,    1,    3,    6,   11,   16,    3,    4,    8,   21,   25,   32,    3,    4,   36,   39,   39,   39,   39],
[    0,    1,    4,    7,   12,   17,    4,    3,    8,   13,   25,   32,    4,    3,   37,   40,   40,   40,   40],
[    0,    1,    3,    4,    3,    4,    3,    4,    3,    4,    3,    4,    3,    4,    8,    8,    8,    1,    1],
[    1,    1,    4,    3,    4,    3,    4,    3,    4,    3,    4,    3,    4,    3,    8,    8,    8,    1,    1],
[    2,    2,    3,    4,    8,    8,    3,    4,   18,   22,   26,   33,    8,   21,   25,   32,    8,    1,    1],
[    2,    2,    4,    3,    8,   13,    4,    3,   19,   23,   27,   16,    8,   21,   25,   32,    8,    1,    1],
[    1,    1,    3,    5,    9,   14,    3,    4,   19,   23,   28,   15,    8,   21,   25,   32,    8,    1,    1],
[    0,    1,    4,    6,   10,   15,    4,    3,   19,   23,   29,   16,    8,   13,   25,   32,    8,    1,    1],
[    0,    1,    3,    6,   11,   16,    3,    4,   19,   23,   30,   16,    8,   21,    0,    0,    8,    1,    1],
[    0,    1,    4,    7,   12,   17,    4,    3,   20,   24,   31,   34,    8,   21,    0,    0,    8,    1,    1],
[    0,    1,    3,    4,    3,    4,    3,    4,    3,    4,    3,    4,    8,    8,    8,    8,    8,    1,    1],
],
"ref":{"0": [0, 0],
"1": [48, 0],
"2": [160, 0],
"3": [32, 32],
"4": [48, 32],
"5": [64, 48],
"6": [80, 48],
"7": [112, 48],
"8": [32, 64],
"9": [64, 64],
"10": [80, 64],
"11": [96, 64],
"12": [112, 64],
"13": [48, 80],
"14": [64, 80],
"15": [80, 80],
"16": [96, 80],
"17": [112, 80],
"18": [160, 128],
"19": [176, 128],
"20": [240, 128],
"21": [64, 144],
"22": [160, 144],
"23": [176, 144],
"24": [240, 144],
"25": [64, 160],
"26": [160, 160],
"27": [176, 160],
"28": [192, 160],
"29": [208, 160],
"30": [224, 160],
"31": [240, 160],
"32": [64, 176],
"33": [160, 176],
"34": [240, 176],
"35": [64, 224],
"36": [80, 224],
"37": [112, 224],
"38": [64, 240],
"39": [80, 240],
"40": [112, 240],
}}